//MAP CONVERTED BY dmm2tgm.py THIS HEADER COMMENT PREVENTS RECONVERSION, DO NOT REMOVE
"b" = (
/obj/machinery/crystal_static/pink,
/turf/simulated/floor/exoplanet/water/shallow,
/area/template_noop)
"j" = (
/turf/template_noop,
/area/template_noop)
"m" = (
/turf/simulated/floor/exoplanet/concrete,
/area/template_noop)
"q" = (
/obj/structure/monolith,
/turf/simulated/floor/exoplanet/concrete,
/area/template_noop)
"t" = (
/obj/machinery/artifact,
/turf/simulated/floor/exoplanet/concrete,
/area/template_noop)
"C" = (
/turf/simulated/floor/exoplanet/water/shallow,
/area/template_noop)
"F" = (
/obj/structure/grille,
/obj/structure/grille,
/turf/simulated/floor/exoplanet/concrete,
/area/template_noop)
"H" = (
/obj/machinery/crystal_static,
/turf/simulated/floor/exoplanet/water/shallow,
/area/template_noop)
"N" = (
/turf/simulated/floor/exoplanet/lava,
/area/template_noop)
"O" = (
/turf/simulated/wall/concrete,
/area/template_noop)
"U" = (
/obj/machinery/crystal_static/orange,
/turf/simulated/floor/exoplanet/water/shallow,
/area/template_noop)
"Y" = (
/obj/structure/grille,
/turf/simulated/floor/exoplanet/concrete,
/area/template_noop)

(1,1,1) = {"
j
j
j
j
j
j
j
j
j
j
j
j
j
j
j
j
j
j
j
j
j
j
j
j
j
"}
(2,1,1) = {"
j
j
j
j
j
j
j
j
j
j
j
j
j
j
j
j
j
j
j
j
j
j
j
j
j
"}
(3,1,1) = {"
j
j
F
Y
Y
Y
Y
Y
Y
Y
Y
Y
Y
Y
Y
Y
Y
Y
Y
Y
Y
Y
Y
j
j
"}
(4,1,1) = {"
j
j
Y
m
m
m
m
m
m
m
m
m
q
m
m
m
m
m
m
m
m
m
Y
j
j
"}
(5,1,1) = {"
j
j
Y
m
C
C
C
C
C
m
C
C
C
C
C
m
C
C
C
C
C
m
Y
j
j
"}
(6,1,1) = {"
j
j
Y
m
C
C
C
C
C
m
C
C
C
C
C
m
C
C
C
C
C
m
Y
j
j
"}
(7,1,1) = {"
j
j
Y
m
C
C
U
C
C
m
C
C
C
C
C
m
C
C
b
C
C
m
Y
j
j
"}
(8,1,1) = {"
j
j
Y
m
C
C
C
C
C
m
C
C
C
C
C
m
C
C
C
C
C
m
Y
j
j
"}
(9,1,1) = {"
j
j
Y
m
C
C
C
C
C
m
C
C
C
C
C
m
C
C
C
C
C
m
F
j
j
"}
(10,1,1) = {"
j
j
Y
m
m
m
q
m
m
O
m
m
q
m
m
O
m
m
q
m
m
m
Y
j
j
"}
(11,1,1) = {"
j
j
Y
m
C
C
C
C
C
m
N
N
N
N
N
m
C
C
C
C
C
m
Y
j
j
"}
(12,1,1) = {"
j
j
Y
m
C
C
C
C
C
m
N
N
N
N
N
m
C
C
C
C
C
m
Y
j
j
"}
(13,1,1) = {"
j
j
Y
q
C
C
H
C
C
q
N
N
t
N
N
q
C
C
H
C
C
q
Y
j
j
"}
(14,1,1) = {"
j
j
Y
m
C
C
C
C
C
m
N
N
N
N
N
m
C
C
C
C
C
m
Y
j
j
"}
(15,1,1) = {"
j
j
Y
m
C
C
C
C
C
m
N
N
N
N
N
m
C
C
C
C
C
m
Y
j
j
"}
(16,1,1) = {"
j
j
Y
m
m
m
q
m
m
O
m
m
q
m
m
O
m
m
q
m
m
m
Y
j
j
"}
(17,1,1) = {"
j
j
Y
m
C
C
C
C
C
m
C
C
C
C
C
m
C
C
C
C
C
m
Y
j
j
"}
(18,1,1) = {"
j
j
Y
m
C
C
C
C
C
m
C
C
C
C
C
m
C
C
C
C
C
m
Y
j
j
"}
(19,1,1) = {"
j
j
Y
m
C
C
b
C
C
m
C
C
C
C
C
m
C
C
U
C
C
m
Y
j
j
"}
(20,1,1) = {"
j
j
Y
m
C
C
C
C
C
m
C
C
C
C
C
m
C
C
C
C
C
m
Y
j
j
"}
(21,1,1) = {"
j
j
Y
m
C
C
C
C
C
m
C
C
C
C
C
m
C
C
C
C
C
m
Y
j
j
"}
(22,1,1) = {"
j
j
Y
m
m
m
m
m
m
m
m
m
q
m
m
m
m
m
m
m
m
m
Y
j
j
"}
(23,1,1) = {"
j
j
F
Y
Y
Y
Y
Y
Y
Y
Y
Y
Y
Y
Y
Y
Y
Y
Y
Y
Y
Y
Y
j
j
"}
(24,1,1) = {"
j
j
j
j
j
j
j
j
j
j
j
j
j
j
j
j
j
j
j
j
j
j
j
j
j
"}
(25,1,1) = {"
j
j
j
j
j
j
j
j
j
j
j
j
j
j
j
j
j
j
j
j
j
j
j
j
j
"}
